9 9
001111111
001111111
100000001
110000111
111101111
111101000
111100010
111111110
111110000
